NO ./tex/blue_rock_wall.xpm
SO ./tex/blue_rock_wall.xpm
EA ./tex/jail.xpm
WE ./tex/jail.xpm

F 0,204,0
C 0,204,255

    111111111111111111
    100000011000000001
    111110011111111101
1111100000111000000001
1111111100000001111111
1111000000011101111111
1111111100111111111111
1100000000111111111001
1000000000111111111111
1000000000111111111111
11111N0001111111111111
1101000011111111111111
1111111011111111111111
1111111000000001111111
1111111111111111111111