NO ./path_to_the_north_texture

SO ./path_to_the_south_texture

WE ./path_to_the_west_texture

EA ./path_to_the_east_texture

F 220,100,0

C 225,30,0

11111 111111111 11111111111
1000000000110000000000001
10110000 01110000000000 001
100100000 0000000000000001
   111111111011000001110000000000001
10000000001100 0001110111111111111
11110111111111011100000010001
  11110 11111111101 1101010010001  
11000000110101011100000010001
1000000000000000 1100000010001
1000 0000000000001101010 010001
11000001110101011111011110N0111
11110111 1110101 101111010001
11111111 1111111 111111111111
